0,0,0,0,0,0,0,0,0,0,0,0,0,0,0,0,0,0,0,0,0,0,0,0,0,0,0,0,0,0
0,0,0,0,0,0,0,0,0,0,0,0,0,0,0,0,0,0,0,0,0,0,0,0,0,0,0,0,0,0
0,0,0,0,0,0,0,0,0,0,0,0,0,0,0,0,0,0,0,0,0,0,0,0,0,0,0,0,0,0
0,0,0,0,0,0,0,0,0,0,0,0,0,0,0,0,0,0,0,0,0,0,0,0,0,0,0,0,0,0
0,0,0,0,0,0,0,0,0,0,0,0,0,0,0,0,0,0,0,0,0,0,0,0,0,0,0,0,0,0
0,0,0,0,0,0,0,0,0,0,0,0,0,0,0,0,0,0,0,0,0,0,0,0,0,0,0,0,0,0
0,0,0,0,0,0,0,0,0,0,0,0,0,0,0,0,0,0,0,0,0,0,0,0,0,0,0,0,0,0
0,0,0,0,0,0,0,0,0,0,0,0,0,0,0,0,0,0,0,0,0,0,0,0,0,0,0,0,0,0
0,0,0,0,0,0,0,0,0,0,0,0,0,0,0,0,0,0,0,0,0,0,0,0,0,0,0,0,0,0
0,0,0,0,0,0,0,0,0,0,0,0,0,0,0,0,0,0,0,0,0,0,0,0,0,0,0,0,0,0
0,0,0,0,0,0,0,0,0,0,0,0,0,0,0,0,0,0,0,0,0,0,0,0,0,0,0,0,0,0
0,0,0,0,0,0,0,0,0,0,0,0,0,0,0,0,0,0,0,0,0,0,0,0,0,0,0,0,0,0
0,0,0,0,0,0,0,0,0,0,0,0,0,0,0,0,0,0,0,0,0,0,0,0,0,0,0,0,0,0
6,6,6,6,0,6,0,0,0,0,0,0,0,0,0,0,0,0,0,0,0,0,0,0,0,0,0,0,0,0
6,6,6,6,6,6,0,0,0,0,0,0,0,0,0,0,0,0,0,0,0,0,0,0,0,0,0,0,0,0
6,6,6,6,6,6,0,0,0,0,0,0,0,0,0,0,0,0,0,0,0,0,0,0,0,0,0,0,0,0
6,6,6,6,6,6,2,2,0,0,2,0,0,0,0,0,0,0,0,0,0,0,0,0,0,0,0,0,0,0
6,6,6,6,6,2,2,2,6,6,2,2,0,0,0,0,0,0,0,0,0,0,0,0,0,0,0,0,0,0
6,6,6,6,2,2,2,6,6,6,6,2,0,0,0,0,0,0,0,0,0,0,0,0,0,0,0,0,0,0
6,6,6,6,2,2,6,6,6,6,6,2,2,6,6,6,6,6,2,2,2,0,0,0,0,0,0,0,0,0
6,6,6,6,2,2,6,6,6,6,6,2,2,2,6,6,6,6,6,6,2,2,0,0,0,0,0,0,0,0
6,6,6,6,2,2,6,6,6,6,6,2,2,2,6,6,6,6,6,6,6,2,0,0,0,0,0,0,0,0
2,2,2,2,2,2,6,6,6,6,2,2,2,2,6,6,6,6,6,6,6,2,0,0,0,0,0,0,0,0
2,2,2,2,2,2,2,6,6,2,2,2,2,2,6,6,6,6,6,6,6,2,0,0,0,0,0,0,0,0
2,2,6,6,6,6,6,6,6,2,2,2,6,6,6,6,2,2,6,6,6,6,2,0,0,0,0,0,0,0
2,6,6,6,6,6,6,6,6,6,2,6,6,6,6,6,2,2,6,6,6,6,2,2,0,0,0,0,0,0
2,6,6,6,6,6,6,6,6,6,6,6,6,6,6,6,2,2,6,6,6,6,2,0,0,0,0,0,0,0
2,6,6,6,6,6,6,6,6,6,6,6,6,6,6,6,2,2,2,6,6,2,2,0,0,0,0,0,0,0
2,2,6,6,6,6,6,2,2,6,6,2,6,6,6,2,2,2,2,6,6,2,2,0,0,0,0,0,0,0
2,2,2,2,2,2,2,2,2,2,2,2,2,2,2,2,2,2,2,2,2,2,2,2,2,2,2,2,2,2
