0,0,0,0,0,0,0,0,0,0,0,7,7,7,7,7,0,0,7,7,7,7,7,0,0,0,0,0,0,0
0,0,0,0,0,0,0,0,0,0,0,0,7,7,7,0,0,0,0,7,7,7,0,0,0,0,0,0,0,0
0,0,0,0,0,0,0,0,0,0,0,0,0,7,0,0,0,0,0,0,7,0,0,0,0,0,0,0,0,0
7,7,7,7,7,7,0,0,0,0,0,0,0,7,0,0,0,0,0,0,7,0,0,0,0,0,0,7,7,7
7,7,7,0,0,0,0,0,0,0,0,0,0,0,0,0,0,0,0,0,0,0,0,0,0,0,0,0,0,7
7,7,0,0,0,0,0,0,0,0,0,0,0,0,0,0,0,0,0,0,0,0,0,0,0,0,0,0,0,7
0,0,0,0,0,0,0,0,0,0,0,0,0,0,0,0,0,0,0,0,0,0,0,0,0,0,0,0,0,7
0,0,0,0,0,0,0,10,10,10,10,10,10,10,10,0,0,0,0,0,7,2,2,2,2,2,7,0,0,7
0,0,0,0,0,0,0,0,0,0,10,10,0,0,0,0,0,0,0,0,7,7,7,7,7,7,7,0,0,7
0,0,0,0,0,0,0,0,0,0,10,10,0,0,0,0,0,0,0,0,0,0,7,7,7,0,0,0,0,0
0,0,0,0,0,0,0,0,0,0,0,0,0,0,0,0,0,0,0,0,0,0,0,0,0,0,0,0,0,0
7,2,2,0,0,2,2,0,0,0,0,0,0,0,0,0,0,0,0,0,0,0,0,0,0,0,0,0,0,0
7,7,0,0,0,0,7,0,0,0,0,0,0,0,0,0,0,0,0,0,0,0,0,0,0,1,1,1,1,1
0,0,0,0,0,0,7,0,0,0,0,0,0,0,0,0,0,0,0,0,0,0,0,0,0,0,0,0,1,1
0,0,0,0,0,0,7,0,0,0,0,0,0,0,0,0,0,0,0,0,0,0,0,0,0,0,0,0,0,1
0,0,0,0,0,0,0,0,2,2,2,2,2,2,2,2,0,0,0,0,0,0,0,0,0,0,0,0,0,0
10,10,10,0,0,0,0,0,0,7,7,7,7,7,7,0,0,0,0,0,0,0,0,0,0,0,0,0,0,0
10,10,10,10,0,0,0,0,0,0,0,0,0,0,0,0,0,0,0,0,7,7,7,0,0,0,0,0,0,0
0,0,10,10,10,10,0,0,0,0,0,0,0,0,0,0,0,0,0,0,0,0,0,0,0,0,0,0,0,0
0,0,0,0,0,0,0,0,0,0,0,0,0,0,0,0,0,0,0,0,0,0,0,0,0,0,0,0,0,0
0,0,0,0,0,0,0,0,0,0,0,0,0,0,0,0,0,0,0,0,0,0,0,0,0,0,0,2,2,2
0,0,0,0,0,0,0,0,0,0,0,0,0,0,0,0,0,0,0,0,0,0,0,0,0,0,0,7,7,0
0,0,0,0,0,0,0,0,0,0,0,0,0,0,0,0,7,7,0,0,2,2,0,0,0,0,0,7,7,0
0,0,0,0,0,0,0,0,0,0,7,7,0,0,0,0,7,7,0,0,7,7,0,0,0,0,0,7,7,0
2,2,0,0,0,0,0,0,0,0,7,7,0,0,0,0,7,7,0,0,7,7,0,0,0,7,7,7,7,0
7,7,0,0,0,0,0,0,0,0,7,7,0,0,0,0,7,7,0,0,7,7,0,0,0,7,7,7,7,0
7,0,0,0,0,7,7,0,0,2,2,2,2,0,0,0,2,2,2,2,2,2,0,0,0,2,2,2,2,2
7,0,0,0,0,7,7,0,0,0,0,0,0,0,0,0,0,0,0,0,0,0,0,0,0,0,0,0,0,0
7,0,0,0,0,7,7,0,0,0,0,0,0,0,0,0,0,0,0,0,0,0,0,0,0,0,0,0,0,0
2,2,2,2,2,2,2,2,2,2,2,2,2,2,2,2,2,2,2,2,2,2,2,2,2,2,2,2,2,2
